2222222002222222220101010101021022
2011022110210110220101010101021022
211200P001211012220101010101021022
2010101010102102220101010101021022
2222222002222222220101010101021022
2011022110210110220101010101021022
2112000001211012221120000012110122
2010101010102102221120000012110122
2222222002222222220101010101021022
2011022110210110110101010101021022
2112000001211012201120000012110122
2010101010102102220101010101021022
2222222002222222220101010101021022
2011022110210110220101010101021022
2112000001211012220101010101021022
2010101010102102220101010101021022