22222222222002222222222222222222201110222222
2OOOOOOOOOOOOOOOOOOOOOOOOOOOOOOO1111OOOOOOO2
2OO1111OOOOOO1111OOO2OOOOOOOO11111211OOOOOO2
2OO1111OO22OO1111OOO2OOOOO111111222111OOOOO2
2OO1111OO22OO1111OOO2OOOOO1111112OOOOOOOOOO2
2OO1111OOOOOO1111OOO2OOOOOOOOOOOOOOOOOO11OO2
2OOOOOOOOOOOOOOOOOO222OOOOO211OOOOOOOOO11OO2
2OOOOOOOOO11OOOOOOO222OOOOOOO11OOO2OOOO11OO2
2OOOOOOOO111OOOOOOOOOOOOPOOOO11OOOO22OO11OO2
2OOOOOOOO1OOOOOOO22OOOOOOOOOOOOOOOOOOOO11OO2
2OOOOOOOOOO11211OOOOOOO22OOOOOOOOOOOOOO11022
2OOO2OOOOOO11112OOOOOOOOOOO11111OOOOOOO11OO2
2OO111OOOOOOO11111OOOOOO11111111OOOOOOO11OO2
2OO111OOOOOOO1112111OOOOOO22211OOOOOOOOOOOO2
2OOO1O11OOOOOOOOOOOOOOO111112OOOOOOOOOOOOOO2
2OOO1OO1OOOOO11111OOOOOO11111OOOOO111OOOOOO2
2OOOO11OOOOOO21112OOOOOOOOOOOOOO11112OOOOOO2
22222222222002222222222222222222201110222222